.s.......x
....s.....
...s......
.\\\\\s...
.\ss......
.\...ss...
.\.ss.....
.\\\\.sss.
.sss\.....
..0\\.ssss